#########
#....#X##
#.....Ob#
#...#..##
#########