#########
#....#X##
#b.O....#
#...#..##
#########