#########
#X#...###
#.#.O.b.#
#.#.#.#.#
#.......#
#..###..#
#########