######
#X..##
#.#O.#
#....#
#...b#
######